################
#       @      #
#XXX     LGVG  #
#              #
#              #
#              #
# OOOOO        #
#              #
#              #
# D            #
#              #
#              #
#              #
#              #
#              #
################
